022302120222
222223111032
301322130302
312322232330
001000100000